4 4 4 4 4 4 4 4 4 4 4 4 4 4 4 4 4 4 4 4 4 4 4 4 4 4 4 4 4 4
4 0 0 0 0 0 0 0 0 0 0 0 0 0 0 0 0 0 0 0 1 0 0 0 0 0 0 0 0 4
4 1 1 1 1 1 1 0 1 1 1 1 1 1 1 0 0 0 1 1 1 1 1 1 1 1 1 1 0 4
4 0 0 0 0 0 1 1 0 0 0 0 0 0 0 0 0 0 0 0 0 0 0 0 0 0 0 0 0 4
4 0 1 1 1 1 1 1 1 1 0 1 1 0 1 1 0 0 0 0 0 1 0 0 0 0 0 1 0 4
4 0 1 1 1 1 0 0 0 0 0 1 1 0 1 1 0 1 0 0 0 1 0 0 0 1 1 1 0 4
4 0 0 1 1 1 0 2 5 5 0 5 5 0 1 1 0 1 0 0 0 1 0 0 0 1 0 0 0 4
4 4 0 1 1 0 0 1 5 3 3 3 5 0 1 0 0 1 0 0 0 1 0 0 1 1 0 0 0 4
4 4 0 0 0 0 0 2 5 3 3 3 5 0 1 0 1 1 0 0 0 0 0 0 1 0 0 0 0 4
4 4 0 1 0 2 4 2 5 3 3 3 5 1 1 1 2 2 0 1 0 0 0 0 0 0 0 1 1 4
4 0 0 1 2 2 4 2 5 3 3 3 5 1 1 1 1 1 0 1 1 1 0 0 0 0 0 0 0 4
4 0 1 1 2 4 2 2 5 5 0 5 5 1 1 1 1 1 0 0 0 1 0 0 0 1 0 0 0 4
4 0 0 0 0 1 0 0 0 0 0 0 1 0 0 0 1 1 0 0 1 1 0 0 0 1 1 1 1 4
4 0 0 0 0 0 0 0 1 1 1 0 0 0 1 0 0 0 0 0 0 0 0 0 0 0 0 0 0 4
4 4 4 4 4 4 4 4 4 4 4 4 4 4 4 4 4 4 4 4 4 4 4 4 4 4 4 4 4 4