4 4 4 4 4 4 4 4 4 4 4 4 4 4 4
4 4 4 4 4 4 4 4 4 4 4 4 4 4 4
4 4 4 4 4 4 4 4 4 4 4 4 4 4 4
4 4 4 4 0 0 0 0 0 0 0 4 4 4 4
4 4 4 4 4 4 4 4 4 4 0 4 4 4 4
4 4 4 4 4 4 4 4 4 4 0 4 4 4 4
4 4 4 4 4 4 4 4 1 1 0 1 1 4 4
4 4 4 4 4 4 4 4 1 3 3 3 1 4 4
4 4 4 4 4 4 4 4 1 3 3 3 1 4 4
4 4 4 4 4 4 4 4 1 3 3 3 1 4 4
4 4 4 4 4 4 4 4 1 3 3 3 1 4 4
4 4 4 4 4 4 4 4 1 1 0 1 1 4 4
4 4 4 4 4 4 4 4 4 4 0 4 4 4 4
4 4 4 4 4 4 4 4 4 4 0 4 4 4 4
4 4 4 4 4 4 4 4 4 4 0 4 4 4 4